0000000000000000000000000000000000000000000000000000000000000000
0000000000000000000000000000000000000000000000000000000000000000
0000000000000000000000000000000000000000000000000000000000000000
0000000000000000000000000000000000000000000000000000000000000000
0000000000000000000000000000000000000000000000000000000000000000
0000000000000000000000000000000000000000000000000000000000000000
0000000000000000000000000000000000000000000000000000000000000000
0000000000000000000000000000000000000000000000000000000000000000
0000000000000000000000000000000000000000000000000000000000000000
0000000000000000000000000000000000000000000000000000000000000000
0000000000000000000000000000000000000000000000000000000000000000
0000000000000000000000000000000000000000000000000000000000000000
0000000000000000000000000000000000000000000000000000000000000000
0000000000000000000000000000000000000000000000000000000000000000
0000000000000000000000000000000000000000000000000000000000000000
0000000000000000000000000000000000000000000000000000000000000000
0000000000000000000000000000000000000000000000000000000000000000
0000000000000000000000000000000000000000000000000000000000000000
0000000000000000000000444444444444444444440000000000000000000000
0000000000000004444444444444444444444444444444444000000000000000
0000000000000004444444444444444444444444444444444440000000000000
0000000000000004444444444444444444444444444444444440000000000000
0000000000000044444444444444444444444444440000000000000000000000
0000000000000000088444444444444444222222220000000000000000000000
0000000000000000088444444444444444222222220000000000044444444400
4440000000000000088444444444444444222222220000000000044444444444
4440000000000000088444444444444444222222220000000000044444444444
4444444488888888888444444444444444422222220000000000044444444444
4444444488888888888444444444444444444444440000000000044444444444
4444444444444444444444444444444444444444444444444444444444444444
4444444444444444444444444444444444444444444444444444444444444444
4444444444444444444444444444444444444444444444444444444444444444
0444444444444444444444444444444444444444444444444444444444444400
0004444444444444444444444444444444444444444444444444444444444000
0000044444444444444444444444444444444444444444444444444444400000
0000000444444444444444444444444444444444444444444444444440000000
0000000000444444444444444444444444444444444444444444440000000000
0000000000000004444444444444444444444444444444444000000000000000
0000000000000000000000444444444444444444000000000000000000000000
0000000000000000000000444444444444444444000000000000000000000000
0000000000000000000000444444444444444444000000000000000000000000
0000000000000000000000444444444444444444000000000000000000000000
0000000000000000000000666666666666666666000000000000000000000000
0000000000000000000000666666666666666666000000000000000000000000
0000000000000000000000000000000000000000000000000000000000000000
0000000000000000000000000000000000000000000000000000000000000000
0000000000000000000000000000000000000000000000000000000000000000
0000000000000000000000000000000000000000000000000000000000000000
0000000000000000000000000000000000000000000000000000000000000000
0000000000000000000000000000000000000000000000000000000000000000
0000000000000000000000000000000000000000000000000000000000000000
0000000000000000000000000000000000000000000000000000000000000000