0000000000000000000000000000000000000000000000000000000000000000
0000000000000000000000000000000000000000000000000000000000000000
0000000000000000000000000000000000000000000000000000000000000000
0000000000000000000000000000000000000000000000000000000000000000
0000000000000000000000000000000000000000000000000000000000000000
0000000000000000000000000000000000000000000000000000000000000000
0000000000000000000000000000000000000000000000000000000000000000
0000000000000000000000000000000000000000000000000000000000000000
0000000000000000000000000000000000000000000000000000000000000000
0000000000000000000000000000000000000000000000000000000000000000
0000000000000000000000000000000000000000000000000000000000000000
0000000000000000000000000000000000000000000000000000000000000000
0000000000000000000000000000000000000000000000000000000000000000
0000000000000000000000000000000000000000000000000000000000000000
0000000000000000000000000000000000000000000000000000000000000000
0000000000000000000000000000000000000000000000000000000000000000
0000000000000000000000222222220000000000000000000000000000000000
0000000000000000000000222222224440000000000000000000000000000000
0000000000000000000000222222224444444400000000000000000000000000
0000000000000000000000222222224444444400000000000000000000000000
0000000000000000000000222222224444444444444444444444444444445555
0000000000114444444444444444444444444444444444444444444444445555
0000000000114444444444444444444444444444444444444444444444445555
0000000000000000044444444444444444444444444444444444444444445555
0000000000000000044444444444444444444444444444400000000000000000
0000000000000000088844444444444444444444444444000000000000000000
0000000000000000088844444444444444444444444400000000000000000000
0000000000000000088844444444444444444400000000000000000000000000
0000000000000000088844444444444444444400000000000000000000000000
0000000000000000088844444444444444444400000000000000000000000000
0000000000000000000444444444444444444400000000000000000000000000
0000000000000000000888888444444444444400000000000000000000000000
0000000000000000000888888444444444444400000000000000000000000000
0000000000000004444444444444444444444400000000000000000000000000
0000000000000000000000000000000000000000000000000000000000000000
0000000000000000000000000000000000000000000000000000000000000000
0000000000000000000000000000000000000000000000000000000000000000
0000000000000000000000000000000000000000000000000000000000000000
0000000000000000000000000000000000000000000000000000000000000000
0000000000000000000000000000000000000000000000000000000000000000
0000000000000000000000000000000000000000000000000000000000000000
0000000000000000000000000000000000000000000000000000000000000000
0000000000000000000000000000000000000000000000000000000000000000
0000000000000000000000000000000000000000000000000000000000000000
0000000000000000000000000000000000000000000000000000000000000000
0000000000000000000000000000000000000000000000000000000000000000
0000000000000000000000000000000000000000000000000000000000000000
0000000000000000000000000000000000000000000000000000000000000000
0000000000000000000000000000000000000000000000000000000000000000
0000000000000000000000000000000000000000000000000000000000000000
0000000000000000000000000000000000000000000000000000000000000000
0000000000000000000000000000000000000000000000000000000000000000