0000000000000000000000000000000000000000000000000000000000000000
0000000000000000000000000000000000000000000000000000000000000000
0000000000000000000000000000000000000000000000000000000000000000
0000000000000000000000000000000000000000000000000000000000000000
0000000000000000000000000000000000000000000000000000000000000000
0000000000000000000000000000000000000000000000000000000000000000
0000000000000000000000000000000000000000000000000000000000000000
0000000000000000000000000000000000000000000000000000000000000000
0000000000000000000000000000000000000000000000000000000000000000
0000000000000000000000000000000000000000000000000000000000000000
0000000000000000000000000000000000000000000000000000000000000000
0000000000000000000000000000000000000000000000000000000000000000
0000000000000000000000000000000000000000000000000000000000000000
0000000000000000000000000000000000000000000000000000000000000000
0044444444444444444444444444444444444444444444444444444444444400
6644444444444444444444444444444444444444444444444444444444444455
6644444444444444444444444444444444444444444444444444444444444455
6644444444444444444444444444444444444444444444444444444444444455
6644444444444444444444444444444444444444444444444444444444444455
6644444444444444444444444444444444444444444444444444444444444455
6644444444444444444444444444444444444444444444444444444444444455
0044444444444444444444444444444444444444444444444444444444444455
0044444444444444444444444444444444444444444444444444444444444444
0044444444444444444444444444444444444444444444444444444444444444
0044444444444444444444444444444444444444444444444444444444444444
0044444444444444444444444444444444444444444444444444444444444444
0044444444444444444444444444444444444444444444444444444444444444
0044444444444444444444444444444444444444444444444444444444444444
0044444444444444444444444444444444444444444444444444444444444444
0044444444444444444444444444444444444444444444444444444444444444
0044444444444444444444444444444444444444444444444444444444444444
0044444444444444444444444444444444444444444444444444444444444444
0044444444444444444444444444444444444444444444444444444444444444
0044444444444444444444444444444444444444444444444444444444444444
0044444444444444444444444444444444444444444444444444444444444444
0044444444444444444444444444444444444444444444444444444444444444
0044444444444444444444444444444444444444444444444444444444444444
0044444444444444444444444444444444444444444444444444444444444444
0044444444444444444444444444444444444444444444444444444444444444
0044444444444444444444444444444444444444444444444444444444444444
0044444444444444444444444444444444444444444444444444444444444444
0044444444444444444444444444444444444444444444444444444444444444
0044444444444444444444444555555555544444444444444444444444444444
0044444444444444444444444555555555544444444444444444444444444444
0000000000000000000000000000000000000000000000000000000000000000
0000000000000000000000000000000000000000000000000000000000000000
0000000000000000000000000000000000000000000000000000000000000000
0000000000000000000000000000000000000000000000000000000000000000
0000000000000000000000000000000000000000000000000000000000000000
0000000000000000000000000000000000000000000000000000000000000000
0000000000000000000000000000000000000000000000000000000000000000
0000000000000000000000000000000000000000000000000000000000000000