00000000000000000000000000000000000000000000000000000000000000000
00000000000000000000000000000000000000000000000000000000000000000
00000000000000000000000000000000000000000000000000000000000000000
00000000000000000000000000000000000000000000000000000000000000000
00000000000000000000000000000000000000000000000000000000000000000
00000000000000000000000000000000000000000000000000000000000000000
00044444444444444444444444444444444444444444444444444444444444444
00044444444444444444444444444444444444444444444444444444444444444
00044444444444444444444444444444444444444444444444444444444444444
66444444444444444444444444444444444444444444444444444444444444444
66444444444444444444444444444444444444444444444444444444444444444
66444444444444444444444444444444444444444444444444444444444444444
66444444444444444444444444444444444444444444444444444444444444444
66444444444444444444444444444444444444444444444444444444444444444
66444444444444444444444444444444444444444444444444444444444444444
66444444444444444444444444444444444444444444444444444444444444444
66444444444444444444444444444444444444444444444444444444444444444
66444444444444444444444444444444444444444444444444444444444444444
66444444444444444444444444444444444444444444444444444444444444444
04444444444444444444444444444444444444444444444444444444444444444
04444444444444444444444444444444444444444444444444444444444444444
44444444444444444444444444444444444444444444444444444444444444444
44444444444444444444444444444444444444444444444444444444444444444
44444444444444444444444444444444444444444444444444444444444444444
44444444444444444444444444444444444444444444444444444444444444444
44444444444444444444444444444444444444444444444444444444444444444
44444444444444444444444444444444444444444444444444444444444444444
44444444444444444444444444444444444444444444444444444444444444444
44444444444444444444444444444444444444444444444444444000000004444
04444444444444444444000000044444444444444440000444444000000000444
00040444444444444400000000004333333333000440000004440000000000000
00000004444444440000000000000333333333000440000000000000000000000
00000000000000000000000000000333333333000000000000000000000000000
00000000000000000000000000000333333333000000000000000000000000000
00000000000000000000000000000333333333000000000000000000000000000
00000000000000000000000000000333333333000000000000000000000000000
00000000000000000000000000000333333333000000000000000000000000000
00000000000000000000000000000333333333000000000000000000000000000
00000000000000000000000000000333333333000000000000000000000000000
00000000000000000000000000000333333333000000000000000000000000000
00000000000000000000000000000333333333000000000000000000000000000
00000000000000000000000000000333333333000000000000000000000000000
00000000000000000000000000000555555555000000000000000000000000000
00000000000000000000000000000555555555000000000000000000000000000
00000000000000000000000000000555555555000000000000000000000000000
00000000000000000000000000000000000000000000000000000000000000000
00000000000000000000000000000000000000000000000000000000000000000
00000000000000000000000000000000000000000000000000000000000000000
00000000000000000000000000000000000000000000000000000000000000000
00000000000000000000000000000000000000000000000000000000000000000
00000000000000000000000000000000000000000000000000000000000000000