0000000000000000000000000000066666666600000000000000000000000000
0000000000000000000000000000066666666600000000000000000000000000
0000000000000000000000000000033333333300000000000000000000000000
0000000000000000000000000000033333333300000000000000000000000000
0000000000000000000000000000033333333300000000000000000000000000
0000000000000000000000000000033333333300000000000000000000000000
0000000000000000000000000000033333333300000000000000000000000000
0000000000000000000000000000033333333300000000000000000000000000
0000000000000000000000000000033333333300000000000000000000000000
0000000000000000000000000000033333333300000000000000000000000000
0000000000000000000000000000033333333300000000000000000000000000
0000000000000000000000000000033333333300000000000000000000000000
0000000000000000000000000000033333333300000000000000000000000000
0000000000000000000000000000033333333300000000000000000000000000
0000000000000000000000000000033333333300000000000000000000000000
0000000000000000000000000000033333333300000000000000000000000000
0000000000000000000000000000033333333300000000000000000000000000
0000000000000000000000000000033333333300000000000000000000000000
0000000000000000000000000000033333333300000000000000000000000000
0000000000000000000000000000033333333300000000000000000000000000
0000000000000000000000000000033333333300000000000000000000000000
0000000000000000000000000000033333333300000000000000000000000000
0000000000000000000000000000033333333300000000000000000000000000
0000000000000000000000000000033333333300000000000000000000000000
0000000000000000000000000000033333333300000000000000000000000000
0000000000000000000000000000033333333300000000000000000000000000
4444444444444444444444444444433333333300000000000000000000000000
0000000000000000000000000000044444444400000000000000000000000000
4444444444444444444444444444444444444400000000000000000000000000
4444444444444444444444444444444444444400000000000000000000000000
4444444444444444444444444444444444444400000000000000000000000000
4444444444444444444444444444444444444444444444444444444444444444
4444444444444444444444444444444444444444444444444444444444444444
4444444444444444444444444444444444444444444444444444444444444444
4444444444444444444444444444444444444444444444444444444444444444
4444444444444444444444444444444444444444444444444444444444444444
4444444444444444444444444444444444444444444444444444444444444444
4444444444444444444444444444444444444444444444444444444444444444
4444444444444444444444444444444444444444444444444444444444444444
4444444444444444444444444444444444444444444444444444444444444444
4444444444444444444444444444444444444444444444444444444444444444
4444444444444444444444444444444444444444444444444444444444444444
4444444444444444444444444444444444444444444444444444444444444444
4444444444444444444444444444444444444444444444444444444444444444
4444444444444444444444444444444444444444444444444444444444444444
4444444444444444444444444444444444444444444444444444444444444444
4444444444444444444444444444444444444444444444444444444444444444
4444444444444444444444444444444444444444444444444444444444444444
4444444444444444444444444444444444444444444444444444444444444444
4444444444444444444444444444444444444444444444444444444444444444
4444444444444444444444444444444444444444444444444444444444444444
4444444444444444444444444444444444444444444444444444444444444444