0000000000000000000000000000000000000000000000000000000000000000
0000000000000000000000000000000000000000000000000000000000000000
0000000000000000000000000000000000000000000000000000000000000000
0000000000000000000000000000000000000000000000000000000000000000
0000000000000000000000000000000000000000000000000000000000000000
0000000000000000000000000000000000000000000000000000000000000000
0000000000000000000000000000000000000000000000000000000000000000
0000000000000000044444444444444444444444442222222222244444444444
0000000000000000444444444444444444444444444444444444444444444444
0000000000000004444444444444444444444444444444444444444444444444
0000000000555550044444444444444444444444444444444444444444444444
0000000000555440444444444444444444444444444444444444444444444444
0000000000554444444444444444444444444444444444444444444444444444
0000000000555444444444444444444444444444444444444444444444444444
0000000000555444444444444444444444444444444444444444444444444444
0000000004444444444444444444444444444444444444444444444444444444
0000000044444444444444444444444444444444444444444444444444444444
0000000444444444444444444444444444444444444444444444444444444444
0000004444444444444444444444444444444444444444444444444444444444
0000044444444444444444444444444444444444444444444444444444444444
0600444444444444444444444444444444444444444444444444444444444444
0604444444444444444444444444444444444444444444444444444444444444
0644444444444444444444444444444444444444444444444444444444444444
0644444444444444444444444444444444444444444444444444444444444444
0644444444444444444444444444444444444444444444444444444444444444
0644444444444444444444444444444444444444444444444444444444444444
0644444444444444444444444444444444444444444444444444444444444444
0444444444444444444444444444444444444444444444444444444444444444
0444444444444444444444444444444444444444444444444444444444444444
0444444444400000000000000000000000000000044444444444444444444000
0444444444000000000000000000000000000000044444444444444444444000
0444444440000000000000000000000000000000444444444444444444444000
0444444400000000000000000000000000000004444444444444444444444000
0444440000000000000000000000000000000044444444444444444444444000
0444400000000000000000000000000000000044444444444444444444444000
0444000000000000000000000000000000000000000444444444444444444000
0440000000000000000000000000000000000000000444444444444444444000
0400000000000000000000000000000000000000004444444444444444444000
0444440000000000000000000000000000000000000004444444444444444444
0444444000000000000000000000000000000000000004444444444444444444
0444444000000000000000000000000000000000000044444444444444444444
0444444000000000000000000000000000000000000044444444444444444444
0444444404000000000000000000000000000000000044444444444444444444
0444444444000444444444444444444000000000000444444444444444444444
0444444444444444444444444444444444444444444444444444444444444444
0444444444444444444444444444444444444444444444444444444444444444
0000000000000000000000000000000000000000000000000000000000000000
0444444444444444444444444444444444444444444444444444444444444444
4444444444444444444444444444444444444444444444444444444444444444
4444444444444444444444444444444444444444444444444444444444444444
4444444444444444444444444444444444444444444444444444444444444444
4444444444444444444444444444444444444444444444444444444444444444
