00000000000000000000000000000000000000000055555555555000000000000
00000000000000000000000000000000000000000055555555555000000000000
00000000000000000000000000000000000000000055555555555000000000000
00000000000000000000000000000000000000000055555555555000000000000
00000000000000000000000000000000000000000055555555555000000000000
00000000000000000000000000000000000000000055555555555000000000000
00000000000000000000000000000000000000000044444444444000000000000
00000000000000000444444444444444444444444444444444444444444444444
00000000000000004444444444444444444444444444444444444444444444444
00000000000000044444444444444444444444444444444444444444444444444
00000000005555500444444444444444444444444444444444444444444444444
00000000005554404444444444444444444444444444444444444444444444444
00000000005544444444444444444444444444444444444444444444444444444
00000000005554444444444444444444444444444444444444444444444444444
00000000005554444444444444444444444444444444444444444444444444444
00000000044444444444444444444444444444444444444444444444444444444
00000000444444444444444444444444444444444444444444444444444444444
00000004444444444444444444444444444444444444444444444444444444444
00000044444444444444444444444444444444444444444444444444444444444
00000444444444444444444444444444444444444444444444444444444444444
06004444444444444444444444444444444444444444444444444444444444444
06044444444444444444444444444444444444444444444444444444444444444
06444444444444444444444444444444444444444444444444444444444444444
06444444444444444444444444444444444444444444444444444444444444444
06444444444444444444444444444444444444444444444444444444444444444
06444444444444444444444444444444444444444444444444444444444444444
06444444444444444444444444444444444444444444444444444444444444444
04444444444444444444444444444444444444444444444444444444444444444
04444444444444444444444444444444444444444444444444444444444444444
04444444444000000000000000000000000000000444444444444444444440000
04444444440000000000000000000000000000000444444444444444444440000
04444444400000000000000000000000000000004444444444444444444440000
04444444000000000000000000000000000000044444444444444444444440000
04444400000000000000000000000000000000444444444444444444444440000
04444000000000000000000000000000000000444444444444444444444440000
04440000000000000000000000000000000000000004444444444444444440000
04400000000000000000000000000000000000000004444444444444444440000
04000000000000000000000000000000000000000044444444444444444440000
04444400000000000000000000000000000000000000044444444444444444444
04444440000000000000000000000000000000000000044444444444444444444
04444440000000000000000000000000000000000000444444444444444444444
04444440000000000000000000000000000000000000444444444444444444444
04444444040000000000000000000000000000000000444444444444444444444
04444444440004444444444444444440000000000004444444444444444444444
04444444444444444444444444444444444444444444444444444444444444444
04444444444444444444444444444444444444444444444444444444444444444
00000000000000000000000000000000000000000000000000000000000000000
04444444444444444444444444444444444444444444444444444444444444444
44444444444444444444444444444444444444444444444444444444444444444
44444444444444444444444444444444444444444444444444444444444444444
44444444444444444444444444444444444444444444444444444444444444444
