00000000000000000000000000000000000000000000000000000000000000000
00000000000000000000000000000000000000000000000000000000000000000
00000000000000000000000000000000000000000000000000000000000000000
00000000000000000000000000000000000000000000000000000000000000000
00000000000000000000000000000000000000000000000000000000000000000
00000000000000000000000000000000000000000000000000000000000000000
00000000000000000000000000000000000000000000000000000000000000000
00000000000000000000000000000000000000000000000000000000000000000
00000000000000000000000000000000000000000000000000000000000000000
00000000000000000000000000000000000000000000000000000000000000000
00000000000000000000000000000000000000000000000000000000000000000
00000000000000000000000000000000000000000000000000000000000000000
00000000000000000000000000000000000000000000000000000000000000000
00000000000000000000000011111110000000000000000000000000000000000
00000000000000000000000011111110000000000000000000000000000000000
00000000000000004444444422222224444444400000000000000000000000000
00000000000000000000444422222224400000000000000000000000000000000
00000000000000004444444422222224440000000000000000000000000000000
00000000000000004444444422222224444444400000000000000000000000000
00000000000000004444444422222224444444400000000000000000000000000
00000000000000004444444422222224444444444444444444444444444445555
00000000000000004444444444444444444444444444444444444444444445555
00000000000000004444444444444444444444444444444444444444444445555
00000000000000004444444444444444444444444444444444444444444445555
00000000000000004444444444444444444444444444444400000000000000000
00000000000000004444444444444444444444444444444000000000000000000
00000000000444444444444444444444444444444444400000000000000000000
00000000000000004444444444444444444444400000000000000000000000000
00000000000444444444444444444444444444400000000000000000000000000
00000000000444444444444444444444444444400000000000000000000000000
00000000000444444444444444444444444444400000000000000000000000000
00000000000044444444444444444444444444400000000000000000000000000
00000000000000444444444444444444444444400000000000000000000000000
00000000000000004444444444444444444444400000000000000000000000000
00000000000000000000000000000000000000000000000000000000000000000
00000000000000000000000000000000000000000000000000000000000000000
00000000000000000000000000000000000000000000000000000000000000000
00000000000000000000000000000000000000000000000000000000000000000
00000000000000000000000000000000000000000000000000000000000000000
00000000000000000000000000000000000000000000000000000000000000000
00000000000000000000000000000000000000000000000000000000000000000
00000000000000000000000000000000000000000000000000000000000000000
00000000000000000000000000000000000000000000000000000000000000000
00000000000000000000000000000000000000000000000000000000000000000
00000000000000000000000000000000000000000000000000000000000000000
00000000000000000000000000000000000000000000000000000000000000000
00000000000000000000000000000000000000000000000000000000000000000
00000000000000000000000000000000000000000000000000000000000000000
00000000000000000000000000000000000000000000000000000000000000000
00000000000000000000000000000000000000000000000000000000000000000
00000000000000000000000000000000000000000000000000000000000000000