0000000000000000000000000000000000000000000000000000000000000000
0000000000000000000000000000000000000000000000000000000000000000
0000000000000000000000000000000000000000000000000000000000000000
0000000000000000000000000000000000000000000000000000000000000000
0000000000000000000000000000000000000000000000000000000000000000
0000000000000000000000000000000000000000000000000000000000000000
0000000000000000000000000000000000000000000000000000000000000000
0000000000000000000000000000000000000000000000000000000000000000
0000000000000000000000000000000000000000000000000000000000000000
0000000000000000000000000000000000000000000000000000000000000000
0000000000000000000000000000000000000000000000000000000000000000
0000000000000000000000000000000000000000000000000000000000000000
0000000000000000000000000000000000000000000000000000000000000000
6600000000000000000000000000000000000000000000000000000000000005
6644444444444444444444444444444444444444444444444444444444444445
6644444444444444444444444444444444444444444444444444444444444445
6644444444444444444444444444444444444444444444444444444444444445
6644444444444444444444444444444444444444444444444444444444444445
6644444444444444444444444444444444444444444444444444444444444445
6644444444444444444444444444444444444444444444444444444444444445
6644444444444444444444444444444444444444444444444444444444444445
0044444444444444444444444444444444444444444444444444444444444445
0044444444444444444444444444444444444444444444444444444444444444
0044444444444444444444444444444444444444444444444444444444444444
0044444444444444444444444444444444444444444444444444444444444444
0044444444444444444444444444444444444444444444444444444444444444
0044444444444444444444444444444444444444444444444444444444444444
0044444444444444444444444444444444444444444444444444444444444444
0044444444444444444444444444444444444444444444444444444444444444
0044444444444444444444444444444444444444444444444444444444444444
0044444444444444444444444444444444444444444444444444444444444444
0044444444444444444444444444444444444444444444444444444444444444
0044444444444444444444444444444444444444444444444444444444444444
0044444444444444444444444444444444444444444444444444444444444444
0044444444444444444444444444444444444444444444444444444444444444
0044444444444444444444444444444444444444444444444444444444444444
0044444444444444444444444444444444444444444444444444444444444444
0044444444444444444444444444444444444444444444444444444444444444
0044444444444444444444444444444444444444444444444444444444444444
0044444444444444444444444444444444444444444444444444444444444444
0044444444444444444444444444444444444444444444444444444444444444
0044444444444444444444444444444444444444444444444444444444444444
0044444444444444444444444555555555544444444444444444444444444444
0044444444444444444444444555555555544444444444444444444444444444
0000000000000000000000000000000000000000000000000000000000000000
0000000000000000000000000000000000000000000000000000000000000000
0000000000000000000000000000000000000000000000000000000000000000
0000000000000000000000000000000000000000000000000000000000000000
0000000000000000000000000000000000000000000000000000000000000000
0000000000000000000000000000000000000000000000000000000000000000
0000000000000000000000000000000000000000000000000000000000000000
0000000000000000000000000000000000000000000000000000000000000000