00000000000000000000000000000000000000000000000000000000000000000
00000000000000000000000000000000000000000000000000000000000000000
00000000000000000000000000000000000000000000000000000000000000000
00000000000000000000000000000000000000000000000000000000000000000
00000000000000000000000000000000000000000000000000000000000000000
00000000000000000000000000000000000000000000000000000000000000000
00000000000000000000000000000000000000000000000000000000000000000
00000000000000000000000000000000000000000000000000000000000000000
00000000000000000000000000000000000000000000000000000000000000000
00000000000000000000000000000000000000000000000000000000000000000
00000000000000000000000000000000000000000000000000000000000000000
00000000000000000000000000000000000000000000000000000000000000000
00000000000000000000000000000000000000000000000000000000000000000
66000000000000000000000000000000000000000000000000000000000000005
66444444444444444444444444444444444444444444444444444444444444445
66444444444444444444444444444444444444444444444444444444444444445
66444444444444444444444444444444444444444444444444444444444444445
66444444444444444444444444444444444444444444444444444444444444445
66444444444444444444444444444444444444444444444444444444444444445
66444444444444444444444444444444444444444444444444444444444444445
66444444444444444444444444444444444444444444444444444444444444445
00444444444444444444444444444444444444444444444444444444444444445
00444444444444444444444444444444444444444444444444444444444444444
00444444444444444444444444444444444444444444444444444444444444444
00444444444444444444444444444444444444444444444444444444444444444
00444444444444444444444444444444444444444444444444444444444444444
00444444444444444444444444444444444444444444444444444444444444444
00444444444444444444444444444444444444444444444444444444444444444
00444444444444444444444444444444444444444444444444444444444444444
00444444444444444444444444444444444444444444444444444444444444444
00444444444444444444444444444444444444444444444444444444444444444
00444444444444444444444444444444444444444444444444444444444444444
00444444444444444444444444444444444444444444444444444444444444444
00444444444444444444444444444444444444444444444444444444444444444
00444444444444444444444444444444444444444444444444444444444444444
00444444444444444444444444444444444444444444444444444444444444444
00444444444444444444444444444444444444444444444444444444444444444
00444444444444444444444444444444444444444444444444444444444444444
00444444444444444444444444444444444444444444444444444444444444444
00444444444444444444444444444444444444444444444444444444444444444
00444444444444444444444444444444444444444444444444444444444444444
00444444444444444444444444444444444444444444444444444444444444444
00444444444444444444444444555555555544444444444444444444444444444
00444444444444444444444444555555555544444444444444444444444444444
00000000000000000000000000000000000000000000000000000000000000000
00000000000000000000000000000000000000000000000000000000000000000
00000000000000000000000000000000000000000000000000000000000000000
00000000000000000000000000000000000000000000000000000000000000000
00000000000000000000000000000000000000000000000000000000000000000
00000000000000000000000000000000000000000000000000000000000000000
00000000000000000000000000000000000000000000000000000000000000000