0000000000000000000000000000000000000000000000000000000000000000
0000000000000000000000000000000000000000000000000000000000000000
0000000000000000000000000000000000000000000000000000000000000000
0000000000000000000000000000000000000000000000000000000000000000
0000000000000000000000000000000000000000000000000000000000000000
0000000000000000000000000000000000000000000000000000000000000000
0004444444444444444444444444444444444444444444444044444444444444
0004444444444444444444444444444444444444444444444044444444444444
0004444444444444444444444444444444444444444444444044444444444444
0044444444444444444444444444444444444444444444444044444444444444
0044444444444444444444444444444444444444444444444044444444444444
0044444444444444444444444444444444444444444444444044444444444444
0044444444444444444444444444444444444444444444444044444444444444
0044444444444444444444444444444444444444444444444044444444444444
0044444444444444444444444444444444444444444444444044444444444444
6644444444444444444444444444444444444444444444444044444444444444
6644444444444444444444444444444444444444444444444044444444444444
6644444444444444444444444444444444444444444444444044444444444444
6644444444444444444444444444444444444444444444444044444444444444
0444444444444444444444444444444444444444444444444044444444444444
0444444444444444444444444444444444444444444444444044444444444444
4444444444444444444444444444444444444444444444444044444444444444
4444444444444444444444444444444444444444444444444044444444444444
4444444444444444444444444444444444444444444444444044444444444444
4444444444444444444444444444444444444444444444444044444444444444
4444444444444444444444444444444444444444444444444044444444444444
4444444444444444444444444444444444444444444444444044444444444444
4444444444444444444444444444444444444444444444444044444444444444
4444444444444444444444444444444444444444444444444044400000000444
0444444444444444444400000004444444444444444000044044400000000044
0004044444444444440000000000499999999900044000000044000000000000
0000000444444444000000000000099999999900044000000000000000000000
0000000000000000000000000000099999999900000000000000000000000000
0000000000000000000000000000099999999900000000000000000000000000
0000000000000000000000000000099999999900000000000000000000000000
0000000000000000000000000000099999999900000000000000000000000000
0000000000000000000000000000099999999900000000000000000000000000
0000000000000000000000000000099999999900000000000000000000000000
0000000000000000000000000000099999999900000000000000000000000000
0000000000000000000000000000099999999900000000000000000000000000
0000000000000000000000000000099999999900000000000000000000000000
0000000000000000000000000000099999999900000000000000000000000000
0000000000000000000000000000055555555500000000000000000000000000
0000000000000000000000000000055555555500000000000000000000000000
0000000000000000000000000000055555555500000000000000000000000000
0000000000000000000000000000000000000000000000000000000000000000
0000000000000000000000000000000000000000000000000000000000000000
0000000000000000000000000000000000000000000000000000000000000000
0000000000000000000000000000000000000000000000000000000000000000
0000000000000000000000000000000000000000000000000000000000000000
0000000000000000000000000000000000000000000000000000000000000000
0000000000000000000000000000000000000000000000000000000000000000