0000000000000000000000000000000000000000000000000000000000000000
0000000000000000000000000000000000000000000000000000000000000000
0000000000000000000000000000000000000000000000000000000000000000
0000000000000000000000000000000000000000000000000000000000000000
0000000000000000000000000000000000000000000000000000000000000000
0000000000000000000000000000000000000000000000000000000000000000
0004444444444444444444444444444444444444444444444444444444444444
0004444444444444444444444444444444444444444444444444444444444444
0004444444444444444444444444444444444444444444444444444444444444
6644444444444444444444444444444444444444444444444444444444444444
6644444444444444444444444444444444444444444444444444444444444444
6644444444444444444444444444444444444444444444444444444444444444
6644444444444444444444444444444444444444444444444444444444444444
6644444444444444444444444444444444444444444444444444444444444444
6644444444444444444444444444444444444444444444444444444444444444
6644444444444444444444444444444444444444444444444444444444444444
6644444444444444444444444444444444444444444444444444444444444444
6644444444444444444444444444444444444444444444444444444444444444
6644444444444444444444444444444444444444444444444444444444444444
0444444444444444444444444444444444444444444444444444444444444444
0444444444444444444444444444444444444444444444444444444444444444
4444444444444444444444444444444444444444444444444444444444444444
4444444444444444444444444444444444444444444444444444444444444444
4444444444444444444444444444444444444444444444444444444444444444
4444444444444444444444444444444444444444444444444444444444444444
4444444444444444444444444444444444444444444444444444444444444444
4444444444444444444444444444444444444444444444444444444444444444
4444444444444444444444444444444444444444444444444444444444444444
4444444444444444444444444444444444444444444444444444400000000444
0444444444444444444400000004444444444444444000044444400000000044
0004044444444444440000000000433333333300044000000444000000000000
0000000444444444000000000000033333333300044000000000000000000000
0000000000000000000000000000033333333300000000000000000000000000
0000000000000000000000000000033333333300000000000000000000000000
0000000000000000000000000000033333333300000000000000000000000000
0000000000000000000000000000033333333300000000000000000000000000
0000000000000000000000000000033333333300000000000000000000000000
0000000000000000000000000000033333333300000000000000000000000000
0000000000000000000000000000033333333300000000000000000000000000
0000000000000000000000000000033333333300000000000000000000000000
0000000000000000000000000000033333333300000000000000000000000000
0000000000000000000000000000033333333300000000000000000000000000
0000000000000000000000000000055555555500000000000000000000000000
0000000000000000000000000000055555555500000000000000000000000000
0000000000000000000000000000055555555500000000000000000000000000
0000000000000000000000000000000000000000000000000000000000000000
0000000000000000000000000000000000000000000000000000000000000000
0000000000000000000000000000000000000000000000000000000000000000
0000000000000000000000000000000000000000000000000000000000000000
0000000000000000000000000000000000000000000000000000000000000000
0000000000000000000000000000000000000000000000000000000000000000
0000000000000000000000000000000000000000000000000000000000000000