0000000000000000000000000000066666666600000000000000000000000000
0000000000000000000000000000066666666600000000000000000000000000
0000000000000000000000000000066666666600000000000000000000000000
0000000000000000000000000000066666666600000000000000000000000000
0000000000000000000000000000099999999900000000000000000000000000
0000000000000000000000000000099999999900000000000000000000000000
0000000000000000000000000000099999999900000000000000000000000000
0000000000000000000000000000099999999900000000000000000000000000
0000000000000000000000000000099999999900000000000000000000000000
0000000000000000000000000000099999999900000000000000000000000000
0000000000000000000000000000099999999900000000000000000000000000
0000000000000000000000000000099999999900000000000000000000000000
0000000000000000000000000000099999999900000000000000000000000000
0000000000000000000000000000099999999900000000000000000000000000
0000000000000000000000000000099999999900000000000000000000000000
0000000000000000000000000000099999999900000000000000000000000000
0000000000000000000000000000099999999900000000000000000000000000
0000000000000000000000000000099999999900000000000000000000000000
0000000000000000000000000000099999999900000000000000000000000000
0000000000000000000000000000099999999900000000000000000000000000
0000000000000000000000000000099999999900000000000000000000000000
0000000000000000000000000000099999999900000000000000000000000000
0000000000000000000000000000099999999900000000000000000000000000
0000000000000000000000000000099999999900000000000000000000000000
0000000000000000000000000000099999999900000000000000000000000000
0000000000000000000000000000099999999900000000000000000000000000
0000000000000000000000000000099999999900000000000000000000000000
0000000000000000000000000000044444444400000000000000000000000000
0044444444444444444444444444444444444400000000000000000000000000
0044444444444444444444444444444444444400000000000000000000000000
0044444444444444444444444444444444444400000000000000000000000000
0044444444444444444444444444444444444444444444444444444444444400
0044444444444444444444444444444444444444444444444444444444444400
0044444444444444444444444444444444444444444444444444444444444400
0044444444444444444444444444444444444444444444444444444444444400
0044444444444444444444444444444444444444444444444444444444444400
0044444444444444444444444444444444444444444444444444444444444400
0044444444444444444444444444444444444444444444444444444444444400
0044444444444444444444444444444444444444444444444444444444444400
0044444444444444444444444444444444444444444444444444444444444400
0044444444444444444444444444444444444444444444444444444444444400
0044444444444444444444444444444444444444444444444444444444444400
0000000000000000000000000000000000000000000000000000000000000000
0000000000000000000000000000000000000000000000000000000000000000
0000000000000000000000000000000000000000000000000000000000000000
0000000000000000000000000000000000000000000000000000000000000000
0000000000000000000000000000000000000000000000000000000000000000
0000000000000000000000000000000000000000000000000000000000000000
0000000000000000000000000000000000000000000000000000000000000000
0000000000000000000000000000000000000000000000000000000000000000
0000000000000000000000000000000000000000000000000000000000000000
0000000000000000000000000000000000000000000000000000000000000000